A as well as B|	B뿐만 아니라 A도
a series of|	연속적인
abandon|	버리다
abide|	지키다
abominate (=disgust)|	혐오하다
abroad|	해외의, 해외로
absolutely|	절대적으로, 완전히
absorb|	흡수하다
absurd|	불합리한
accept|	받아들이다
accidentally|	우연스럽게
accommodate|	숙박 시키다
accommodation|	숙박, 수용
accompany|	~와 동반하다
accomplish|	성취하다
accuracy|	정확성
accurate|	정확한
accuse|	고소하다
accuse A of B|	A를 B의 이유로 고소하다
achieve|	성취하다, 이룩하다
achievement|	업적, 성취
acid|	산, 산성인
acknowledge|	인정하다
acquaintance|	지인, 아는사람
acquire|	얻다
acquisition|	획득, 습득
activate|	활성화 시키다
adapt|	적응하다
address|	연설하다, 해결하다
adequate|	알맞은
adjust|	조절하다, 적응하다
administer|	관리하다, 주다
administration|	관리, 경영, 행정부
administrator|	관리자
admission|	입장료, 입장
admit|	인정하다, 시인하다
adolescent|	청년, 젊은이, 청년기의
adopt|	채택하다, 입양하다
adore|	좋아하다
adorn|	장식하다
advantage|	이점
adverse|	역의, 반대의, 불리한
advertise|	광고하다
affair|	일, 사건
affect|	영향을 끼치다
affection|	애정
affirmation|	확언, 확인, 단언
afford|	~할 여유가 있다, 제공하다
against|	~와 반대하여 ~쪽으로
agenda|	의제
agent|	대리인
aggravate|	악화시키다
aimlessly|	목적없이
aisle|	복도
alert|	민감한, 위험,경고하다
align with|	~와 일직선으로 맞추다, 정렬시키다
all or nothing|	모아니면 도
alliance|	동맹, 연합
allocate|	할당하다
allowance|	수당, 용돈
ally|	동맹하다, 연합하다
alternative|	대안, 양자택일의
altitude|	고도
amend|	개정하다, 수정하다
amount|	양, 합계가 ~이르다
ample|	광대한, 넓은
amuse|	~을 즐겁게 하다
analyst|	분석가
analyze|	분석하다
ancestor|	조상
announce|	알리다, 발표하다
anonymity|	익명성
anonymous|	익명의, 신원 불명의
anthropology|	인류학
anxiety|	걱정
apologize|	사과하다
appeal|	매력, 호소하다
appetite|	식욕
appreciate|	감사하다, 감상하다, 이해하다
approach|	접근하다
appropriate|	적절한, 알맞은
aptitude|	적성, 성향
arbitrary|	임시적인, 임의의
architect|	건축가
architecture|	건축
arise|	일어나다, 발생하다
arrangement|	준비, 배열
arrogant|	거만한
artery|	동맥
as if S V|	마치 ~인 것처럼
as to|	~에 관하여
ascend|	상승하다
assemble|	조립하다, 짜맞추다
assembly|	조립
assess|	평가하다
assessment|	평가
assign|	할당하다, 배정하다
associate A with B|	A를 B 와 연관시키다
assume|	가정하다, 생각하다
assure|	보증하다
astonish|	~을 놀라게 하다
astrology|	점성학
astronomical|	천문의
astronomy|	천문학
atmosphere|	대기, 분위기
attach|	첨부하다
attack|	공격하다
attain|	달성하다, 차지하다
attention|	주의 집중
attentive|	주의하는, 관심갖는
attitude|	태도
attract|	끌다, 매혹하다
attractive|	매력적인
owe A to B|	A를B의 탓으로 돌리다
attribute A to B|	A를 B의 탓으로 돌리다
audible|	들을 수 있는, 들리는
audience|	관중
auditory|	청각의, 귀의
author|	작가
autograph|	사인, 사인하다
autonomy|	자율성, 자치
available|	이용가능한
avenge|	복수하다
avoid|	피하다
aware|	알다
awareness|	앎, 인식
awkward|	어색한
ban|	금지하다
banquet|	연회
barter|	물물교환
basement|	지하실
be |~ at the mercy	좌지우지 되다
be accustomed to ~ing|	~에 익숙하다
be aware of|	알다
be bound to v|	할수밖에 없다
be capable of|	~할 능력이 있는
be inclined to|	~하는 경향이 있다
be likely to v|	~하기 쉽다
consist of|	~로 구성되다
be obsessed with|	강박관념을 가지다, 사로잡히다
be prone to v|	~하기 쉽다
be reluctant to|	~하는 것을 꺼리다
be responsible for|	~역할을 하다, 책임을 지다
be subject to|	~하기로 되어있다
be worth ~ing|	~할 가치가 있다
bear in mind = keep in mind|	명심하다
beard|	턱수염
behave|	행동하다
behavior|	행동
belief|	신념, 믿음
belong|	~에 속하다
belonging|	소속, 소유
bend|	구부리다
beneath|	~아래
betray|	배신하다
beverage|	음료
beware|	조심하다
bewilder|	당황하게 하다
bias|	편견
bid|	입찰하다
biological|	생물학적인
biology|	생물학
bite|	물다, 물림
bitter|	쓴, 쓰라린
bizarre|	기묘한
block|	막다
bloom|	꽃, 개화
blossom|	개화하다
board|	게시판, 판자, 타다
bombard|	쏟아붓다, 폭격하다
botanical|	식물의, 식물학의
boundary|	경계
bow|	활, 숙이다, 절하다
branch|	지점
break into|	침입하다
breaking new|	속보
breakthrough|	돌파구, 성공, 약진
breathe|	호흡하다
bride|	신부
bring up|	기르다, 양육하다
broadcast|	방송하다, 방송
brutal|	야만적인, 사악한
budget|	예산
bully|	불량배, 약자를 괴롭히는 사람
burden|	짐, 짐지우다
burial|	묻을 수 있는
bury|	묻다
by ~ing|	~함으로써
by all means|	반드시
cabbage|	양배추
calculate|	계산하다
calculation|	계산
cancer|	암
capacity|	능력, 수용능력
carry out|	수행하다
carton|	용기, (한)갑
cast|	던지다
catastrophe|	재앙, 참사
category|	분류, 범주
cause|	야기하다
celebrity|	유명인사
celestial|	하늘의, 천체의
cemetery|	공동묘지
censor|	검열하다
certainty|	확실성, 확실함
certificate|	인증서, 증명서
challenge(|동사)	도전하다, (이의)제기하다
channel|	수로, 경로
chaotic|	혼돈스러운
cheat|	사기치다, 속이다
chemical|	화학적인
cherish|	소중히 하다
choke|	억누르다, 숨막히게 하다
chop|	쪼개다
circuit|	순회, 회전
circular|	원의
circulate|	순환하다
circulation|	순환
circumstance|	상황
civilian|	평민, 시민
civilization|	문명
claim|	주장하다, 제기하다, 빼앗다
clan|	씨족
classify|	분류하다
climate|	기후
closet|	벽장
clue|	단서, 실마리
clumsy|	서툰
clutter|	흩어뜨리다, 어지럽히다
coffin|	관
cognitive|	인식의, 인식하는
cognizant|	인식하고 있는
collapse|	쓰러지다, 주저앉다, 무너지다
colleague|	동료
collect|	수집하다, 모으다
collide|	충돌하다
combat|	싸우다
combine|	결합시키다
combustion|	연소
come up with|	생각해내다
comfort|	편안하게 하다
command|	명령하다, 명령
comment|	말하다, 논평하다
commercial|	상업적인
commitment|	책무, 약속, 전념, 헌신
commodity|	상품
companion|	친구, 동반자
companionship|	동료애
compare|	비교하다
compassion|	동정
compatible|	양립할 수 있는, 공용할 수 있는, 적합한
compete|	경쟁하다
competent|	유능한
complain|	불평하다
complement|	보충하다, 보완하다
complete|	완성하다, 완수하다
compliance|	순응
comply|	순응하다
compromise|	타협하다, 위태롭게 하다
comrade|	동료, 동지
conceal|	숨기다
conceivable|	생각할수 있는, 상상할 수있는
conceive|	상상하다, 임신하다
concentrate|	집중하다
concern|	걱정, 관심,염려하다, 연관이있다, 관심이 있다
concerning|	~에 관하여
conclude|	결론내리다, 결론짓다
conclusion|	결론
condense|	응축하다, 압축하다, 요약하다
condition|	~에 필요조건이다, 좌우하다, 조건, 상태
confidence|	자신, 신뢰, 믿음
confine|	제한하다
confirm|	확인하다
conflict|	갈등
confront|	마주하다, 대면하다
confuse|	혼란시키다
confusion|	혼란
connection|	관계, 연결
conscience|	양심
conscious|	의식적인
conservationist|	보호주의자
consider|	생각하다, 고려하다
considerate|	사려깊은
consistent|	일관적인, 일치하는
constant|	끊임없는
constitute|	구성하다
consume|	소비하다
contact|	접촉하다, 연락하다
contagious|	전염성이 있는
contemplate|	사색하다(think), 응시하다
contend|	경쟁하다, 주장하다
content|	내용, 만족한
contract|	계약,계약하다, 수축하다
contraction|	수축
contradict|	반대하다, 반박하다, 모순되다
contrast|	대조
contribute to|	~에 공헌하다
controversial|	논란이 많은, 논쟁이 되는
converse|	대화하다
convert|	전환하다, 바꾸다
conviction|	확신, 유죄
corporation|	기업, 업체
correct|	바로잡다, 수정하다, 올바른
correspond|	~에 상응하다, 일치하다
corrupt|	썩은, 부패시키다, 매수하다
cottage|	오두막
cotton|	면
couch|	소파
cough|	기침하다
council|	의회
counter|	반대하다, 반대, 반대로
courage|	용기
craft|	만들다, 공예
crave|	갈망하다
craving|	갈망
creature|	생명체
credibility|	믿음, 신용
credit|	신용, 믿음
crew|	직원, 선원
crime|	범죄
critic|	비평가
criticize|	비판하다
crowd|	혼잡한
crude|	날것의(=raw), 조잡한
crunch time|	위기
crush|	으깨다, 부수다
cultivation|	경작
cure|	치료하다
deal with|	다루다, 처리하다
debt|	빚
decay|	부패하다,부패
deceive = cheat|	속이다
decent|	알맞은, 적당한
declare|	선언하다, 선포하다
decline|	하락, 감소, 감소하다
decode|	해독하다
deem|	~라고 여기다
defeat|	패배, 패배시키다
defect|	결점, 결함
defend|	막다, 방어하다
defense|	방어
deficient|	결핍된
deficit|	부족, 결손
define|	정의하다
definite|	명백한
definition|	정의
deliberate|	신중한, 심사숙고한, 고의로
deliver|	배달하다, 전달하다
demean|	비하하다
demonstrate|	설명하다, 묘사하다
demoralize|	~의 사기를 꺾다, 혼란시키다
dense|	빽빽한
depart|	출발하다
department|	부서, 매장
departure|	출발, 시작
depend on =rely on|	~에 의존하다
depict|	묘사하다, 그리다
deplete|	고갈되다
depletion|	고갈
deposit|	퇴적시키다
deposition|	퇴적물, 파면
deprive|	빼앗다, 박탈하다
descend|	하강하다
descendant|	자손, 후예
describe|	묘사하다
deserted|	황량한
deserve|	~할 가치가 있다, ~받을 만하다
deserved|	당연한
desire|	바램, 바라다
despair|	절망
desperate|	필사적인, 절망적인
destination|	목적지
detach|	분리하다
detect|	찾다
deteriorate|	나쁘게하다, 타락시키다
determinative|	결정적인, 확정적인
determine|	결정하다
detest|	증오하다
detract|	떨어뜨리다
devote (=dedicate =commit)|	몰두하다, 헌신하다
devote|	~에 전념하다, 헌신하다
devour|	게걸스럽게 먹다
diabetes|	당뇨
diaper|	기저귀
dictate|	받아쓰다, 명령하다, 명령
dictator|	독재자
differ|	~와 다르다
digestive|	소화의
dignity|	위엄
diligence|	부지런함
dilute|	희석시키다, 묽게 하다
dimension|	차원, 측면
diminish|	감소하다
diminish (=decrease)|	줄이다, 축소하다, 작아지다
dinosaur|	공룡
direct|	지시하다, 관리하다, ~을 향하게 하다
disability|	불구, 무능력
disabled =handicapped|	불구의, 장애의
disaster|	재해
discern|	인식하다, 구별하다
disclose|	드러내다
disconnect|	차단하다
discover|	발견하다
discredit|	불신하다
dismount|	내려가다
disorder|	혼란, 장애
disparage|	폄하하다
disperse (=scatter)|	흩어지게 하다, 흩어뜨리다
displace|	옮기다, 교체하다
display|	전시하다
displease|	불쾌하게 하다
disregard|	무시하다
disrupt|	혼란에 빠지게 하다, 중단시키다
distance|	거리
distinctive|	독특한, 구별되는
distinguish|	구별하다
distract|	흩어뜨리다, 분열시키다
distress|	고민, 걱정, 비탄
distribute|	분배하다
district|	지역, 구역
diverse|	다양한
diversity|	다양성
divinity|	신, 신학
divorce|	이혼, 분리, 이혼하다
domestic|	가정의, 국내의
dominate|	점거하다, 점유하다
donate|	기부하다
doom|	운명, 비운, 불행한 운명을 맞게 되다
downstair|	계단
drainage|	배수
drip|	뚝뚝 떨어뜨리다, 흘리다
drop out of|	중퇴하다
drown|	익사하다
duplicate|	복제하다, 복사하다
duty|	의무
earthquake|	지진
eco-friendly|	친환경적인
economical|	경제적인
economist|	경제학자
ecosystem|	생태계
edible|	먹을 수 있는
educate|	교육하다
efficient|	효율적인
ego|	자아
elastic|	탄성의
eligible|	적격의 ~할 자격이 있는
eliminate|	제거하다
eloquent|	말 잘하는, 유창한
embed|	끼워넣다
embody|	구현하다, 구체화시키다
embrace|	껴안다, 수용하다
emerge|	나타나다, 출현하다
emigrate|	이주해 나가다
emit (=shed)|	발산하다
emit|	방출하다, 발산하다
emotion|	감정
empathetic (= empathic)|	공감할 수 있는
emphasize|	강조하다
empirical|	경험적인, 실용적인
employ|	고용하다, 이용하다
employee|	직원
employer|	사장
empower|	~에게 권한을 부여하다
enable A to v|	A가 to v 하는 것을 가능하게 하다
enchant|	매혹시키다
enclose|	둘러싸다, 동봉하다
encounter|	(우연히)만나다, 마주치다
encourage|	격려하다, 장려하다
encouragement|	격려
end up ~ing|	결국 ~하게 되다
endow|	기부하다, 주다
endure|	지속하다, 견디다
engage in|	~에 참여하다, 종사하다
enlarge|	확대시키다
enlist|	참가하다, 입대하다, 기재하다
ensure|	보증하다, 확실히 하다
entail|	필요로하다, 수반하다
entangle|	얽히다
entertain|	즐겁게 하다
enthusiasm|	열정
entire|	전체의
entrance|	입구, 입장
envious|	질투하는
equality|	평등
erupt|	분출하다
escape|	탈출하다, 도망가다
essence|	본질
essential|	필수적인, 본질적인
ethics|	윤리학
ethnic|	민족의
evade|	회피하다
evaluate|	평가하다
eventually|	결국에, 마침내
evict|	추방하다
evident|	분명한
evil|	사악한
evitable|	피할 수 있는
evoke|	불러 일으키다, 떠올리다
evolution|	진화
exaggerate|	과장하다
excavate|	발굴하다, 파다
exceed|	능가하다, 초과하다
exclaim|	외치다
exclude|	배제하다
exclusive|	독점적인,배타적인
excuse|	변명하다
executive|	중역, 이사
exert|	발휘하다, 행사하다
exhibit|	전시하다, 보여주다
exist|	존재하다
expand|	팽창하다, 확대하다
expansion|	팽창
expectation|	기대
expedition|	탐험(대)
expenditure|	지출
experiment|	실험
expert|	전문가
expiration|	(계약)만료
expire|	만료하다
explain|	설명하다
explicit|	명백한, 분명한
exploit|	착취하다, 이용하다
export|	수출하다, 수출
expose|	노출하다
exposure|	노출
extend|	늘이다, 확장하다(길이)
extensive|	광범위한
extent|	정도, 범위
external|	외부적인
extra|	여분의, 특별한
extraordinary|	특별한
extreme|	극한, 극도의
fabric|	직물
facilitate|	촉진시키다, ~를 용이하게 하다
facility|	시설
faculty|	재능, 능력, 교수
faint|	희미해지다, 졸도하다
fake|	가짜의
familiar|	익숙한, 친숙한
famine|	기근
fascinate|	유혹하다, 꼬시다
fasten|	고정시키다, 잠그다
fatal|	중요한, 치명적인
favor|	~을 좋아하다, 선호하다
feat|	공훈, 공적, 위업
feature|	특징, 모습, ~을 특집으로 하다, 특색짓다
fee|	요금
feed|	먹이를 주다, 공급하다
feel like ~ing|	~하고 싶다
fellow|	동료
feminine|	여성의, 여성다운
fiber|	섬유, 섬유질
figure out|	이해하다, 파악하다
financial|	재정적인
fix|	고치다, 고정시키다
flaw|	결점
flee|	달아나다
flipper|	지느러미
flood|	홍수
flourish|	번성하다, 번영하다
flow|	흐름, 흐르다
fluctuate|	요동치다, 오르내리다
fluid|	유동적인, 체액, 수분
folk|	사람들, 민속의, 민간의
forbid (= prohibit = prevent)|	금지시키다
forecast|	예보하다, 예측하다
forecaster|	예보자
foretell|	예언하다
forgo|	포기하다
formidable|	무서운
formulate|	공식화하다, (체계적으로)나타내다
formulation|	공식화, 체계화
fossil|	화석
foster|	촉진하다, 양육하다
fraction|	일부, 소량
frequency|	빈번함
frighten|	놀라게 하다, 두렵게 하다
frontier|	미개척지
frown|	찌푸리다
frustrate|	좌절시키다
fulfill|	충족시키다, 이행하다
funeral|	장례식
furnish|	갖추어 놓다, 비치하다
furthermore|	게다가
gain|	얻다
gap|	차이
garage|	차고
garment|	의복
gasp|	숨이 턱 막히다. 숨막힘
gather|	모으다, 모이다
gem|	보석
general|	일반적인
generate|	일으키다, 발생시키다
generation|	세대
generosity|	관대
generous|	관대한
genetic|	유전적인
genius|	천재
germ|	세균
get in|	방해하다, 들어가다
get out of|	~로부터 나오다
get rid of|	제거하다
gifted|	재능있는
giggle|	낄낄 웃다
gist|	요점
give in|	굴복하다, 받아들이다
given|	~을 가정하면, ~을 고려하면
gleam|	빛, 빛나다
glide|	미꾸러지듯이 움직이다
glimpse|	언뜻보다, 언뜻봄
gloomy|	우울한
go after|	추구하다, ~에 열내다
gossip|	험담, 소문
grab|	잡다
gradually|	점차적으로
grain|	곡식(한알)
grant|	주다
grasp|	쥐다, 붙잡다, 붙잡기
grateful|	감사하는
gratitude|	감사
graze|	풀 뜯다
grief|	슬픔
grind|	갈다
grip|	움켜잡다,움켜짐
groan(=moan)|	신음 소리를 내다(고통)
groom|	신랑
grumble|	불평하다
guarantee|	보장하다, 확실히하다, 보증
guidance|	안내
guilty|	유죄
handle|	다루다, 취급하다
hands on|	직접적인
harbor|	항구
hardship|	고난, 역경
hatred|	증오
have a lot of to do with|	~와 연관이 많다
have little to do with|	~와 연관이 거의 없다
have something to do with|	~과 약간 연관있다
head for|	~로 향하다
heir|	상속자
helpless|	무기력한
heredity|	유전
heritage|	유산, 유물
hesitate|	주저하다
hesitation|	주저함
hide|	숨다, 숨기다
hold one's breath|	숨을 멈추다(참다)
hold out|	버티다, 견디다
honor|	기리다
hop|	(깡총)뛰다
horizontal|	수평의
hospitality|	환대
host|	주최하다, 주인
howling|	울부짓는
huge|	거대한
humid|	습기있는
humidity|	습도
humility|	겸손
hygiene|	위생
hypothesis|	가설, 전제
hypothesize|	가설을 세우다
identical|	동일한
identify|	알다 확인하다
ignorance|	무지, 무식
ignore|	무시하다
illiteracy|	무지함
illuminate|	비추다, 조명하다
immediate|	인접한, 즉각적인
immediately|	즉시, 인접하여
immense|	거대한
immerse|	몰입하다, (액체)담그다
immoral|	비도덕적인
impair|	손상시키다
impede|	훼방하다, 방해하다
impertinent|	무례한
implement|	이행하다, 실행하다
imply|	암시하다
import|	수입하다 수입
impression|	인상, 인상을 주다
imprison|	가두다
improve (= enhance)|	올리다, 향상시키다
in terms of|	~의 관점에서
in the light of|	~의 관점으로
inborn|	타고난
incapable|	~할 능력이 없는
incentive|	동기 자극
incident|	사건
inclusive|	~을 포함하여
income|	수입
incomparably|	비교할 수 없을 정도로
inconsistency|	일관성 없음, 모순
inconvenience|	불편함
incredible|	믿을 수 없는
indifference|	무관심
indigenous|	토착의
indignant|	분개한, 성난
indispensable|	버릴수 없는, 필수적인
individuality|	개성
induce|	유도하다
industry|	산업
inevitable|	피할 수 없는
infer|	추론하다
infertility|	메마름, 불임
infinite|	무한한
inflame|	~을 자극하다, 염증을 일으키다
inflation|	부풀림
inflict|	(고통) 주다, 가하다
influence|	영향, 영향을 끼치다
inform|	전달하다
infrastructure|	기반구조
infringement|	침해
ingenuity|	독창성
ingredient|	요소, 성분
inhale|	들이 마시다
inherit|	물려받다, 상속하다
inhibit|	금지하다, 방해하다
initiative|	솔선, 주도
innate|	타고난
innocent|	무죄의, 순결한
innovative|	혁신적인
inquire|	질문하다
insight|	통찰력
insightful|	통찰력있는
insist|	주장하다
inspect|	조사하다
inspector|	조사자
inspiration|	영감
inspire|	영감을 불어넣다
instinct|	본능
institute|	설립하다, 설치하다
institution|	단체
instruction|	지시, 교육
instructor|	가르치는 사람, 교수
instrument|	기구, 도구
insulate|	단열하다
insulation|	단열
insulator|	단열재
insurance|	보험
insure|	보증하다
intake|	섭취
intelligible|	이해할 수 있는, 알기 쉬운
intend to v|	~할 의도가 있다
intensive|	집중적인
intention|	의도
interact|	상호작용하다
interplay|	상호작용
interpret|	해석하다
interrupt|	가로막다, 방해하다
interval|	간격
intervention|	중재, 간섭, 도움
intimidate|	위협하다, 겁주다
intrigue|	호기심을 불러 일으키다, 음모를 꾸미다
invade|	침략하다
invaluable|	매우 귀중한
invent|	발명하다
inventory|	목록
investigate|	조사하다
investment|	투자
irregular|	불규칙적인
irritability|	짜증
isolate|	고립시키다
issue|	문제, 쟁점, 발행, 발행하다, 발급하다
jam|	밀어넣다, 쑤셔넣다
janitor|	수위
jar|	항아리, 단지
junk|	쓰레기
juvenile|	청소년의
keen|	간절히 원하는, 예리한
keep ~ing|	계속해서 ~ing 하다
keep |목 from ~ing	목적어가 ~ing 하는 것을 막다
stop |목 from ~ing	목적어가 ~ing 하는 것을 막다
kidney|	신장
kinship|	친족
knit|	짜다, 뜨다
label|	상표, 꼬리표, ~에 표를 붙이다
laden|	짐을 싫은
lament|	한탄하다 애도하다 슬퍼하다
lateral|	측면의, 옆의
lay out|	설계하다
layoff|	해고
lead|	납, 이끌다
leather|	가죽
leave behind|	남겨두다
leave out|	생략하다, 남겨지다.
lecture|	강의
legacy|	유산
lethal|	치명적인
liberation|	자유
license|	면허
lifelong|	평생
light up|	밝아지다, 반짝이다, 빛나다
liken|	비유하다
limit|	제한 한계
line up|	준비하다
linger|	머물다, 남다
literally|	말그대로 문자그대로
litter|	쓰레기
livelihood|	생계
load|	짐, 부담, 짐싣다
logic|	논리적인
lonely|	외로운
long|	갈망하다
long-term|	장기간의
lubricate|	미끈하게 하다
mad|	성난, 화난
magnificent|	웅장한 거대한
magnitude|	규모, 크기
maintenance|	유지, 지속, 유지비
make sense|	이치에 맞다
mammal|	포유동물
manage to v|	가까스로(간신히) ~하다
mandatory|	의무적인, 강제적인
maneuver|	조작, 조작하다
marginalize|	하찮게 여기다, 무시하다
masculine|	남성의, 남성다운
match|	~와 맞다, 부합하다
material|	물질, 자료
matter|	문제, 중요하다
mature|	성숙한, 자라다, 성숙하다
maxim|	격언
mayor|	시장
meanwhile|	한편
mediate|	중재하다
medieval|	중세의
the former|	전자에서
meditate|	명상하다, 깊이 생각하다
meet|	충족시키다
melt|	녹이다
mend|	수선하다, 수리하다
mercy|	재량
metabolism|	신진대사
meteorologist|	기상학자
method|	방법
mind|	마음, 꺼리다
minister|	목사, 장관
miserable|	비참한
mistreat|	학대하다, 혹사하다
misunderstanding|	오해
mixture|	혼합물
mob|	군중, 폭도
mobility|	이동성
mobilize|	동원하다, 결집시키다
mock|	우롱하다
moderate|	적절한, 온화한
modesty|	겸손함
modify|	수정하다
morale|	사기
motivation|	동기
mount|	올라가다
mountain (= chain)|	산맥
muddy|	진흙의
murder|	살인, 살인자
muscle|	근육
mutation|	변이, 변화
mute|	(소리)를 줄이다, 작게하다
myth|	미신
nag|	잔소리로 괴롭히다, 들볶다
naive|	순진한
narrative|	이야기, 담화
narrow|	좁은
nasty|	고약한, 끔찍한
needle|	바늘
neglect|	소홀히하다, 무시하다
nerve|	신경
nervous|	걱정하는, 신경의
neutrality|	중립성
never before nor since|	전무후무하게
no avail|	헛되이
no longer (= not |~ any more)	더이상 ~아니다
no matter how (= however)|	아무리 ~일지라도
no matter where (= wherever)|	~어디든지
nod|	끄덕이다
norm|	규범, 기준
not |~ at all	전혀 ~아니다
nothing but|	단지, 오직
notice|	알아채다, 눈치채다, 공지하다
notion|	개념
notorious|	악명높은
nourish|	영양분을 주다
nuisance|	성가신존재, 귀찮은존재
numb|	마비된
nurture|	기르다, 양육하다
nutrition|	영양분
obedience|	복종
obesity|	비만
object|	물체, 대상, 목적
objective|	객관적인
obligate|	속박하다, ~할 의무를 지우다.
obligation|	의무
obscure|	애매한, 애매하게 하다, 가리다
observance|	준수
observe|	관찰하다, 준수하다
obsession|	집착
obtain|	얻다
obvious|	분명한
occurrence|	발생, 사건
odd|	기묘한, 홀수(=odd number)
odds|	가능성
offer|	제공하다
official|	직원, 관리
offspring|	자손, 자식
old-fashioned|	구식의
omit|	빠뜨리다, 생략하다
on one's way|	~하는 도중에
on top of that|	무엇보다도
opportunity|	기회
oppose|	반대하다
opposite|	반대의
optical|	시각의
optimism|	낙관주의
optimist|	낙관주의자
optimistic|	낙관적인, 긍정적인
option|	선택
ordinary|	평범한
organism|	유기체
organization|	조직, 기구
organize|	구성하다
orient|	동양, 동양의,~로 향하게 하다
ornament|	장식품, 장신구, 장식하다
orphan|	고아
otherwise|	그렇지 않으면
outcome|	결과
outgrow|	~더 성장하다, (몸이 커져)입지 못하다
overlook|	내려다보다, 간과하다
overthrow|	전복시키다
overwhelm|	압도하다
owe|	빚지다
owing to|	~ 때문에
painkiller|	진통제
paradox|	역설, 모순
parallel|	유사점, 유사성
paralyze|	마비시키다
parliament|	의회
party|	일행, 단체, 무리
passage|	악장, 문장, 통행
passion|	열정
passionate|	열정적인
pat|	가볍게 치다
patch|	헝겊조각
paternity|	아버지의, 부의
patience|	인내
patient|	환자, 인내심이 있는
patron|	후원자
pay attention to|	~에 주의를 기울이다
peak|	절정
pedestrian|	보행자
peek|	엿보다
peer|	보다, 응시하다, 또래, 동년배
penetrate|	침투하다
pension|	연금
perceive|	인식하다, 지각하다
perception|	인식, 지각
perceptual|	지각의, 인식의
perform|	수행하다
peril|	위험
perish|	멸망하다 죽다
permanent|	영구적인
permit|	허락하다, 허락
perpetual|	영속적인
persist|	지속되다, 계속되다
personality|	개성, 성격
personnel|	직원, 직원의
perspective|	전망, 원근법
persuasive|	설득력있는
pertinent|	타당한, 적당한
pessimism|	비관주의
pessimist|	비관주의자
pessimistic|	비관적인
pest|	해충
pesticide|	살충제, 해충제
physiological|	생리적인, 생리학의
pick one's nose|	코를 후비다
pile|	쌓다
pioneer|	개척자
pitch|	던지다, 음높이, (감정,활동) 정도
plant|	심다, 식물
plateau|	고원
plausible|	그럴듯한
plead|	간청하다, 호소하다
plunge|	탐닉하다, 빠지다
pneumonia|	페렴
poetry|	시
point|	가리키다
pointed|	뾰족한
poison|	독
polish|	닦다, 윤기를 내다
politician|	정치가
pollute|	오염 시키다
popularity|	인기
portion|	일부, 부분, 몫
potent|	강력한, 유력한
pour|	쏟아붓다
powder|	분말 분을 바르다
practical|	실제적인, 실용적인
practice|	연습하다, 연습, 관행
pray|	기도하다
precede|	선행하다, 앞서가다
precise|	정확한
precision|	정확성
predator|	포식자
predecessor|	선임자
predict|	예측하다
predictive|	예측하는
prefer A to B|	A를 B보다 더 좋아하다
preference|	선호, 좋아함
pregnant|	임신한
preoccupy|	선점하다
prescribe|	처방하다,규정하다
presence|	존재, 참석
present|	제시하다, 제안하다, 출석한, 선물
preserve|	보존하다
pressure|	압력, 압박하다
presume|	추정하다
presumtion|	추정, 가정
pretend|	~인체하다
prevalent|	널리 퍼진
previous|	이전의
prey|	먹이
priority|	우선순위
prison|	감옥
private|	사적인
privilege|	특권
probe|	탐사하다
procedure|	절차
proceed|	나아가다, 전진하다
procession|	행렬, 전진
profession|	직업
professor|	교수
proficiency|	숙련도
profit|	이익
progress|	발전하다, 진보하다, 진보
prohibit|	금지하다
project|	계획하다, 투영하다
prominent|	저명한, 유명한
pronounce|	발음하다
proof|	증거
proper|	적절한, 알맞은
property|	재산, 속성, 특성
prophecy|	예언
prophesy|	예언하다
prophet|	예언가
proportion|	비율, 부분
pros and cons|	장단점
prospect|	전망, 답사하다
protect|	보호하다
protest|	저항하다
provoke|	불러일으키다
proximity|	근접성
psychiatrist |[sikai]	정신과 의사
publication|	출판물, 발행
publish|	출판하다
pulse|	맥박
punishment|	처벌
pupil|	학생
purpose|	목적
pursue|	추구하다
quality|	질, 자질
quantity|	양
quarrel|	논쟁하다, 싸우다
quest|	추구
questionnaire|	설문지
queue|	줄서다
radiate|	(빛) 발하다, 방사하다, 퍼뜨리다
radical|	급진적인
rag|	넝마조각, 해진 천
raid|	공습하다, 습격
raise|	기르다, 올리다
rake|	갈퀴
random|	무작위의
rate|	비율, 평가하다
ratio|	비율
ration|	정량, 배급량
rationale|	이론적 설명(근거)
raw|	날것의, 원재료의
realm|	왕국, 영역
recall|	상기시키다
receive|	받다
recess|	휴식
recession|	후퇴, 침체
recipient|	수령자, 수령인
reckless|	무모한
reckon|	간주하다, 여기다
recognize|	인식하다, 알다
recommend|	추천하다
reconstruct|	재구성하다, 재건축하다
reconstruction|	재건축, 재구성
record|	기록하다
recover|	회복하다
recovery|	회복의
recruit|	모집하다
reef|	수초
refer to|	참고하다, 언급하다
reformation|	개혁
reframe|	재구성하다
refrigerator|	냉장고
refuge|	피신, 피난
refugee|	피난자, 난민
refuse to v|	to v할 것을 거부하다
regime|	정권
region|	지역
register|	등록하다
regress|	퇴보하다, 퇴화하다
regression|	퇴화
regret|	후회하다
regular|	규칙적인, 정기적인
regulate|	조절하다, 통제하다
regulation|	규제, 규정
reinforce|	강화하다
relate|	연관시키다
relation|	관계
relative|	친척
release|	출시하다, 내놓다
relentless|	무모한
relevant|	관련된, 적절한, 타당한
remain|	남다, 유지하다
remark|	말, 논평
remarkable|	주목할 만한, 두드러진
remind|	떠오르게 하다, 상기시키다
remote|	~먼, 멀리 떨어진
remove|	제거하다
render|	만들다
rent|	임대료, 빌리다
repeat|	반복하다
replace|	교체하다 대체하다
reply|	응답하다, 대답
represent (= indicate)|	나타내다
representative|	대표자
reproduce|	번식시키다
reptile|	파충류
request|	요청하다
require|	필요로하다, 요구하다
resemble|	닮다
resent|	분개하다
reservation|	예약
resident|	거주민
resilience|	회복력
resist|	저항하다
respect|	존경하다
respiration|	호흡
respiratory|	호흡기의
respond|	응답하다, 반응하다
responsibility|	책임, 역할
responsible|	~ 책임이 있는, ~ 역할을 하는
restore|	복구하다, 회복하다
restraint|	억제, 자제
restrict|	제한하다, 규제하다
restriction|	제한, 규제
result from|	~로부터 나오다
result in|	야기하다, 초래하다
resume|	재개하다
retain|	보유하다
retire|	은퇴하다
retrieve|	회복하다, 복구하다
reunite|	재결합 시키다
reveal|	드러내다, 폭로하다
revenge|	복수, 복수하다
revise|	개정하다, 수정하다
revision|	개정, 수정
revive|	소생하다
rhetoric|	수사학, 미사여구 (과장된 말)
rid|	제거하다
ridiculous|	어처구니없는
ripple|	퍼지다, 물결이 일다
rise|	오르다
rise to one's feet|	일어서다
ritual (= ceremony)|	의식
roast|	굽다, 구운고기
role|	역할
rotate|	회전시키다
rotten|	썩은
rough|	거친
roughly|	대략, 거의
rubbish|	쓰레기
rule|	규칙, 통제하다
sacred|	성스러운
sage|	현인, 현자
sake|	목적, 자체
sanitary|	위생의, 위생적인
save|	저장하다, 아끼다, 구하다
scarce|	희귀한, 드문
scarcity|	희소성
scatter|	분산시키다
scholar|	학자
scrape|	긁어내다, 긁다
sculpture|	조각
seagulls|	갈매기
second-hand|	중고
secure|	확실히하다, 확보하다
security|	안전, 보안
seduce|	유혹하다
seed|	씨앗, 씨앗뿌리다
seek|	찾다, 추구하다
seem to v|	~인 것 같다
seize|	체포하다, 점령하다
seldom|	좀처럼 ~아니다(부정)
selection|	선택
senator|	상원의원
sensitive|	민감한
sentence|	문장
sequence|	연속, 순서
serious|	심각한
servant|	하인
service|	봉사
set up|	설치하다
settle|	정착하다, 설치하다, 해결하다
sew|	바느질 하다
sewage|	하수, 오물
shallow|	삼키다, 얕은
shed|	발산하다, (눈물, 피) 흘리다, 헛간
sheer|	완전한, 절대적인
shelter|	피난처
shelve|	선반
shift|	이동, 변화, 이동하다
shortcoming|	단점
shovel|	삽
show off|	뽐내다
show up|	등장하다
shrink|	수축하다, 줄어들다
shrug|	움츠리다
shrug off A as B|	A를 B로 여겨 밀쳐내다
sibling|	형제, 자매
sign|	신호
similarity|	비슷함
simplicity|	간단함, 단순함
sincere|	성실한, 진실한
sincerity|	진실, 성실
sink|	가라앉다
sip|	모금, 찔끔마시다
skeletal|	골격의
skeleton|	골격, 뼈대
skeptic|	회의론자, 비관론자
skepticism|	비관주의
skyscraper|	고층건물
slap (= beat)|	찰싹 때리다, 치다
sleeve|	소매
slide|	미끄러져 움직이다
slight|	약간의, 가벼운
slightly|	약간, 조금
snatch|	낚아채다
sneak|	(몰래)빠져나가다, 도망치다
sneeze|	재채기하다
so |형(부) that s v	너무 ~해서 ~하다
so that s v|	~하기 위해서
soak|	적시다
sole|	오직하나, 발바닥, 유일한
solidity|	단단함, 입체성
solution|	해결책
solve|	풀다, 해결하다
sort|	종류, 분류하다
sour|	신, 시큼한
spare|	할애하다, 떼어놓다
spawn|	낳다, 생산하다
species|	종
specific|	구체적인, 명료한
spectator|	관중
speculate|	깊이 생각하다, 사색하다, 추측하다
spill|	엎지르다
spine|	척추
spiritual|	영혼의, 정신의
spit|	침뱉다
spouse|	배우자
spread|	퍼지다
sprout|	발아하다, 싹트다.
stable|	안정된, 마굿간
stack|	쌓다, 세우다
stagger|	비틀거리다, 비틀거림
stain|	얼룩
stand|	참다, 견디다
stand out|	두드러지다, 눈에 띄다
standard|	표준의
state|	상태, 진술하다, 국가
static|	정적인
status|	지위
stay up at night|	밤새다
steady|	꾸준한
steep|	가파른
steer|	조종하다, 몰고가다
stem|	줄기
stepping stone|	디딤돌
stick out|	내밀다, 찌르다
sticky|	끈끈한
stiff|	뻣뻣한
stimulate|	자극하다
sting (= prick)|	찌르다
stir|	휘젓다, 자극하다
stitch|	꿰매다, 한바늘(땀)
straightforward|	명확한, 솔직한
stranger|	이방인, 낯선사람
strategy|	전략
stray|	흩어진, 길잃은
strength|	힘
stretch|	늘이다, 펴다
strict|	엄격한
stride|	큰걸음, 큰걸음으로 걷다
strike|	파업, 치다, (갑자기 )떠오르다
strip|	벗기다
strive|	노력하다
stroll|	산책하다, 산책
struggle|	투쟁하다, 노력하다
subconscious|	잠재의식의
subject|	과목, 주제, 대상(실험, 그림)
subjective|	주관적인
submarine|	잠수함
submit|	복종하다, 제출하다
subordinate|	부하직원
subscribe|	구독하다
subsequent|	이후의, 다음의, 뒤이어 일어나는
subsidize|	보조금을 주다
substance|	물질
substitute|	대체하다
subtle|	미묘한, 섬세한
suburb|	교외
suck|	빨다
suffer|	겪다. 고통받다
suicide|	자살
suit|	맞추다, 맞다
suitable|	알맞은, 적절한
sundial|	해시계
superb|	최고의
supervise|	감독하다, 지휘하다
supplement|	보충물, 보충제
supply|	공급하다
supportive|	뒷받침하는, 보완하는, 보충하는
suppress|	억누르다
surface|	표면
surge|	급증, 급증하다, 물결치다
surgery|	외과수술
surround|	둘러싸다
survey|	조사, 조사하다
sustain|	지속하다
swap|	교체하다
swarm|	떼를 짓다
sweep|	쓸다
switch|	바꾸다
symbol|	상징
symbolize|	상징하다
synchronize|	일치시키다, 조화시키다
systematic|	체계적인
take A for granted|	A를 당연시하다
take in|	섭취하다
take off|	이륙하다, 벗기다
take on|	떠맡다, (책임)지다, 띠다
take over|	장악하다, 지배하다, 물려받다
tap|	두드리다
tease|	조롱하다
temporarily|	일시적으로, 임시적으로
tenant|	세입자
tend to v|	~하는 경향이 있다
terminal|	종착역, 끝
terminate|	끝내다, 종결시키다
terminology|	전문용어
territory|	영토, 지역
textile|	직물, 직물의
that is why|	그래
the latter|	후자의
the number of|	~의수
thick|	두꺼운
thought(|명사)	생각
thread|	맥락, 실
threaten|	위협하다
thrive|	번영하다
tickle|	간지럽히다
ticklish|	간지러운
tilt|	기울다
timely|	시기적절한
tissue|	조직
tolerance|	관용
tomb|	무덤
toss|	던지다
toxic|	독성의
trace|	흔적, 추적하다
transcendental|	초월한, 뛰어난
transfer|	건네다, 옮기다
transform|	변형시키다
transmission|	전달, 전송
transmit|	전달하다
transparent|	투명한, 명백한
transport|	운송, 교통, 수송하다
treatment|	치료, 대접
treaty|	조약
tremendous|	엄청난, 웅장한
tribe|	부족
trim|	손질하다, 손질된
tropical|	열대의
tune to|	~에 맞추다
turn A into B|	A를 B로 바꾸다
twist|	꼬임, 구불구불한
typhoon|	태풍
ultimate|	궁극적인
ultimately|	궁극적으로
unconquerable|	정복할 수 없는
uncoordinated|	조화가 되지 않는, 어색한
undergo|	겪다
underlie|	~의 근본이 되다
underlying|	근원적인, 근본적인
undermine|	훼손시키다, 약화시키다
underscore|	강조하다, 밑줄 긋다
undo|	취소하다
unemployment|	실업
unify|	통합하다
universal|	보편적인
unjust|	부당한
unload|	덜다, 짐내리다
unorganized|	정돈되지 않은
unprecedented|	전례없는
unselfish|	이타적인
upcoming|	다가오는
uphold|	지지하다
upside down|	거꾸로
upstream|	상류
used to V|	~하곤 했다
useless|	쓸모없는
utensil|	(가사)기구, 도구
vacancy|	텅빈
vague|	애매한
validate|	증명하다, 타당하게 하다
valley|	계곡
valuable|	귀중한
variation|	변형, 변화
variety|	다양성
various|	다양한
vary|	다양하게 하다
vast|	광대한
vehicle|	차량
vein|	정맥
vendor|	노점상인
verify|	확인하다, 검증하다
versus|	~대
vertical|	수직적인
vessel|	관, 배
vice versa|	반대로, 거꾸로
victim|	희생자
vista|	경치
vivid|	생생한
vocation|	천직 직업
vulnerable|	연약한, 취약한, 상처입기 쉬운
wage|	임금
wander|	방황하다
waste|	쓰레기, 낭비, 낭비하다
weave|	짜다, 엮다, 뜨다
well-being|	행복
when it comes to |+명사	~에 관해서
whereas|	반면에
whisper|	속삭이다
wipe|	닦아내다
with regard to|	~에관해서
withdraw|	인출하다, 취소하다, 철회하다
witness|	목격하다, 목격자
woeful|	슬픔에찬, 비참한
wonder|	궁금히 여기다
worse|	더 나쁜
worsen|	악화시키다
yawn|	하품하다
yield|	산출하다, 수확하다
yield to|	양보하다, 굴복하다
accumulate|	쌓다, 축적하다
aggress|	공격하다
aggressive|	공격적인
ambiguous|	애매모호한
analogy|	비유, 유사점
anecdote|	일화, 개인적 진술
assert|	주장하다
aesthetic|	미적인, 미학의
be liable to v|	~하기 쉽다
be obliged to v|	반드시 ~해야한다
dismiss|	묵살하다, 해고하다
clarity|	분명함, 명료함
commit|	저지르다
compel|	강요하다
compound|	화합물, 혼합물, 혼합하다
criminal|	범죄의, 범죄자
customize|	주문제작하다
deceit|	사기, 기만
delegate|	위임하다
derive A from B|	A를 B로부터 얻다
detour|	우회하다
deviant|	벗어난, 이탈하는
dip|	담그다, 내려가다, 낮추다
discard|	버리다
discharge|	해고하다, 석방하다, 배출하다
entitle|	~할 자격을 주다
even|	균등한
expertise|	전문지식
fragment|	조각, 파편, 해체되다,부수다
frame|	틀, 뼈대
hinder|	막다, 방해하다
humble|	겸손한, 초라한
illusion|	환상, 착각
impose|	부과하다
incorporate|	포함하다, 설립하다
intense|	강렬한
intensify|	강화하다.
keep up with|	~을 따라잡다.
liberty|	자유
manifest|	나타내다, 나타나다.
manifestation|	표시, 나타남
manipulate|	조작하다
mindful|	~을 유념하는, ~을 신경쓰는
overlap|	겹치다, 포개다
prevail|	우세하다, 널리 퍼지다
refrain from Ving|	~하는걸 막다, 삼가하다
resolute|	단호한, 확고한
resolution|	결의, 해결
solitary|	고독한
specify|	규명하다, 명시하다
spice|	맛, 양념
be subjected to|	명사 ~을 당하다, ~을 겪다
synthesize|	합성하다
take note of|	주목하다
toll|	통행료, 요금, (종)울리다
transition|	이행, 전환
unit|	(구성)단위
unfold|	펼치다
versatile|	다재다능한
valid|	타당한, 유효한
weird|	이상한
headquarter|	본점
stem from|	~로부터 나오다
lethally|	치명적으로
autonomous|	자율적인, 자치의
bring together|	묶다, 합치다
urge|	욕구, 충동, 충고하다
access|	접근, 접근하다
identify with|	~와 동일시 하다.
reverse|	뒤바꾸다, 뒤집다, 반대
consent|	동의,합의, 동의하다
be consistent with|	~와 일치하다
literacy|	읽고 쓸줄 아는 능력
integrate|	통합시키다.
take into account|	고려하다.
disapprove|	반박하다.
signify|	의미하다,나타내다
masterpiece|	걸작
motivate|	동기 부여하다.
approve|	찬성하다, 승인하다.
